00000000000000000000000000000000000000000
00000111111111111111111100000000000000000
00000100000000000000000100000000000000000
00000100000000000000000100000000000000000
00000111111111110000000100000000000000000
00000000000000010000000100000000000000000
00000000000000010000000100000000000000000
00000000000011110000000100000000000000000
00000000000010000000000100000000000000000
21111100000010000000000100000000000000000
00000100000010000000000100000000000000000
00000100000010000000000111111111111111113
00000100000010000000000000000000000000000
00000111110010000000000000000000000000000
00000000011110000000000000000000000000000
00000000000000000000000000000000000000000
00000000000000000000000000000000000000000
00000000000000000000000000000000000000000
00000000000000000000000000000000000000000
00000000000000000000000000000000000000000
00000000000000000000000000000000000000000