0000000000000000000000000000000000000000
0000000000000000000000000000000000000000
0000000500550000000005555000000000000000
5055550000555555055550005555555555000000
0000050505505055555555555555555505000000
0000555555555555555555555555555505000000
0050500555555555511111111114115505000000
0505555551111111115555555515515555000000
5511111111555555555555555515515550000000
5015551551111111115554111415515511114113
5512551555555555514111551555515515515500
0555551555555555515551551550515515510500
5555551111111111115001551555515510410550
5055555555515555505051551505515511150050
5000055555511115505551551505515510150050
5000000555555511111111111555511111150500
0000000000555555555555555550555555550500
0005500000050555555555555555555550000500
0000000000000550000000000000005550000000
0000000000555000000000555555555000000000
