0000000000000000000000000000000000000000
0000000000000000000000000000000000000000
0000000000000000000000000000000000000000
0000000000000000000000000000000000000000
0000000000000000000000000000000000000000
0000000000000000000000000000000000000000
0000000001111111111111111114111110000000
0000000001000000000000000010010010000000
0011111111000000000000000010010010000000
0010001001111111110004111410010014114103
0012001000000000014111001000010010010000
0000001000000000010001001000010010010000
0000001111111111110001001000010010410000
0000000000010000000001001000010011100000
0000000000011110000001001000010010100000
0000000000000011111111111111114111100000
0000000000000000000000001000010000000000
0000000000000000000000001111110000000000
0000000000000000000000000000000000000000
0000000000000000000000000000000000000000
