0000000000000000000000000000000000000000
0000011111111111111111110000000000000000
0000010000000000000000010000000000000000
0000010000000000000000010000000000000000
0000011111111111000000010000000000000000
0000000000000001000000010000000000000000
0000000000000001000000010000000000000000
0000000000001111000000010000000000000000
0000000000001001000000010000000000000000
2111110000001001111111110000000000000000
0000010000001000000000040000000000000000
0000010000001000000000011111111111111113
0000010000001000000000000000000000000000
0000011111001000000000000000000000000000
0000000001111000000000000000000000000000
0000000000000000000000000000000000000000
0000000000000000000000000000000000000000
0000000000000000000000000000000000000000
0000000000000000000000000000000000000000
0000000000000000000000000000000000000000
0000000000000000000000000000000000000000
