0000000000111111111111111111100000000000
0000000000100000000000000000100000000000
0000000000100111111111111110100000000000
0000000000100100000000000010100000000011
0000000000100101111111111010100000000001
0000000000100101000000001010100000000000
0000000000100101011111101010100000000000
0000000000100101010000101010100000000000
0000000000100101010000101010100000000000
0000000000100101010111101010100000000000
0000000000100101010000001010100000000000
0000000000100101011111111010100000000000
0000000000100101000000000010100000000001
0000000000100101111111111110100000000000
0000000000100100000000000000100000000010
0000000001000111111111111111100000000100
0000000001000000000000000000000000001000
0000000001000000000000000000000000110000
0000000001000000000000000000001101000000
0000000001000000111111111000011000000000
